#################################### 
||................ ...............|| 
||.%%%%%%%%%%%%%  .  %%%%%%%%%%%%.|| 
||.              |.|             .|| 
||.              |.|             .|| 
||.              |.|             .|| 
||.              |.|             .|| 
||.%%%%%%%%%%%%%  .  %%%%%%%%%%%%.|| 
||................................|| 
||.              | |             .|| 
|| ............... .............. || 
||.              |.|             .|| 
||.%%%%%%%%%%%%%  .  %%%%%%%%%%%%.|| 
||................................|| 
||.              |.|             .|| 
||.              |.|             .|| 
||.              |.|             .|| 
||.              |.|             .|| 
||.%%%%%%%%%%%%%  .  %%%%%%%%%%%%.|| 
||................ ...............|| 
#################################### 
